 m __________________________
|        |          |        | 
|  _____ |  _____     ______ |
| |      |       |   |  |    |
| |______|____   |__    |   _|
|    |   _____|     |___|  | |
|---    |        |_____|     |
|       |           |        |
|  _____|           |     ___|
|           |       |        |
|___________|_______|______  |                                      